0000000000000000000000000000000
0111111441411114111411414141110
0101010401010404010101040404010
0114411111444114111111411141410
0101010101040101040401010101040
0411111111141441141141111111110
0101010101010101010401040101010
0411411111141141111114111111110
0101010104010101040401010101010
0411114411411111114111111111110
0104010101010101040101010101010
0111111111004111411411111111110
0000000000000000000000000000000