00000000000000000000
01111114414111111110
01010104010101010140
01144111114441111110
01010101010401010140
04111111111411111110
01010101010101010140
04111111111111111110
01010101010101010140
04111111111111111110
01010104010101010110
01111114111111111110
01010401010101010100
01111111111111111110
00000000000000000000